NO ./textures/wall3_dark.png
SO ./textures/wall2.png
WE ./textures/wall3.png
EA ./textures/wall2_dark.png

D ./textures/door2.png
D1 ./textures/doorWall3.png
D2 ./textures/doorWall4.png

F 50,50,56

C 68,68,68

1011111111111111111111111
10100000011000000000S001
11110X0011100000000000001
101000000000000000000001111111111
111111111011000001112100000000001
100000000011000001112111111111111
11110111111111011100022010001
11110111111111011101011010001
11000000110101011100000010001
10000000000000001100000010001
10000000000000001101010010000000000
1100000111010101111101111000111
11110111  110101 101111010001
11111111  111111 111111111111