NO ./textures/mossy.png
SO ./textures/colorstone.png
WE ./textures/greystone.png
EA ./textures/purplestone.png

D ./textures/door.png
D1 ./textures/doorWall1.png
D2 ./textures/doorWall2.png

F 68,68,68

C 204,215,255




111111111111111111111111
100000000000000000000001
100000000000000000000001
100000000000010000000001
100000000000011100000001
100000000000220100000001
100000000000011100000001
100000000000010000000001
100E00000000000000000001
100000000000000000000001
100000000000011100000001
100000000000022100000001
100000000000011100000001
100000000000000000000001
100000000000000000000001
100000000000000000000001
100000000000000000000001
111111111111111111111111